1111111111111111111111111111111111111111111111111111111111111111111111111111111111111111111111111111
1111111111111111111111111111111111111111111111111111111111111111111111111111111111111111111111111111
1111111111111111111111111111111111111111111111111111111111111111111111111111111111111111111111111111
1111111111111111111111111111111111111111111111111111111111111111111111111111111111111111111111111111
1111111111111111111111111111111111111111111111111111111111111111111111111111111111111111111111111111
1111111111111111111111111111111111111111111111111111111111111111111111111111111111111111111111111111
1111111111111111111111111111111111111111111111111111111111111111111111111111111111111111111111111111
1111111111111111111111111111111111111111111111111111111111111111111111111111111111111111111111111111
1111111111111111111111111111111111111111111111111111111111111111111111111111111111111111111111111111
1111111111111111111111111111111111111111111111111111111111111111111111111111111111111111111111111111
1111111111111111111111111111111111111111111111111111111111111111111111111111111111111111111111111111
1111111111111111111111111111111111111111111111111111111111111111111111111111111111111111111111111111
1111111111111111111111111111111111111111111111111111111111111111111111111111111111111111111111111111
1111111111111111111111111111111111111111111111111111111111111111111111111111111111111111111111111111
1111111111111111111111111111111111111111111111111111111111111111111111111111111111111111111111111111
1111111111111111114141111111111111111111111111111111111111111111111111111111111111111111111111111111
1111111111111111414441411111111111111111111111111111111111111111111111111111111111111111111111111111
1111111111111111141441111111211111111111111111111111111111111111111111111111111111111111111111111111
1111111111111114411111441141222222222111111111111111111111111111111111111111111111111111111111111111
1111111111111141414414111414222222222111111111111111111111111111111111111111111111111111111111111111
1111111111111111111444144114222222222111111111111111111111111111111111111111111111111111111111111111
1111111111111111141444444444222222222111111111111111111111111111111111111111111111111111111111111111
1111111111111114441442222222222222222414111111111111111111111111111111111111111111111111111111111111
1111111111111111411142222222222222222222211111111111111111111111111111111111111111111111111111111111
1111111111111111111142222222222222222222211111111111111111111111111111111111111111111111111111111111
1111111111111111414442222222222222222222211111111111111111111111111111111111111111111111111111111111
1111111111111111441142222222222222222222211111111111111111111111111111111111111111111111111111111111
1111111111115511114442222222222222222222211111111111111111111111111111111111111111111111111111111111
1111111111115514111442222222222222222222241111111111111111111111111111111111111111111111111111111111
1111111111115511411442222222222222444444441111111111111111111111111111111111111111111111111111111111
1111111111115511141142222222222222222222411111111111111111111111111111111111111111111111111111111111
1111111111155111114442222222222222222222111111111111111111111111111111111111111111111111111111111111
1111111111155551141442222222222222222222111111111111111111111111111111111111111111111111111111111111
1111111111155551111442222222222222222222111111111111111111111111111111111111111111111111111111111111
1111111111155155111442222222222222222222111111111111111111111111111111111111111111111111111111111111
1111111111111155111442222222222222222222111111111111111111111111111111111111111111111111111111111111
1111111111111111111414444442222222222222111111111111111111111111111111111111111111111111111111111111
1111111111111111111111114442222222222222111111111111111111111111111111111111111111111111111111111111
1111111111111111111111144142222222222222111111111111111111111111111111111111111111111111111111111111
1111111111111111111111444442222222222222111111111111111111111111111111111111111111111111111111111111
1111111111111111111111144442222222222222111111111111111111111111111111111111111111111111111111111111
1111111111111111111111114442222222222222111111111111111111111111111111111111111111111111111111111111
1111111111111111111111111442222222222222111111111111111111111111111111111111111111111111111111111111
1111111111111111111111111142222222222222111111111111111111111111111111111111111111111111111111111111
1111111111111111111111111142222222222222111111111111111111111111111111111111111111111111111111111111
1111111111111111111111111111411114411111111111111111111111111111111111111111111111111111111111111111
1111111111111111111141111111444411114111111111111111111111111111111111111111111111111111111111111111
1111111111111111111111411111111114441144111111111111111111111111111111111111111111111111111111111111
1111111111111111111111111111114114444444111111111111111111111111111111111111111111111111111111111111
1111111111111111111111114111141144111444141111111111111111111111111111111111111111111111111111111111
1111111111111111111111111111141141141444111111111111111111111111111111111111111111111111111111111111
1111111111111111111111114111114411144411111111111111111111111111111111111111111111111111111111111111
1111111111111111111111111111111111144411111111111111111111111111111111111111111111111111111111111111
1111111111111111111111111111111111441111111111111111111111111111111111111111111111111111111111111111
1111111111111111111111111111111111111111111111111111111111111111111111111111111111111111111111111111
1111111111111111111111111111111111111111111111111111111111111111111111111111111111111111111111111111
1111111111111111111111111111111111111111111111111111111111111111111111111111111111111111111111111111
1111111111111111111111111111111111111111111111111111111111111111111111111111111111111111111111111111
1111111111111111111111111111111111111111111111111111111111111111111111111111111111111111111111111111
1111111111111111111111111111111111111111111111111111111111111111111111111111111111111111111111111111
1111111111111111111111111111111111111111111111111111111111111111111111111111111111111111111111111111
1111111111111111111111111111111111111111111111111111111111111111111111111111111111111111111111111111
1111111111111111111111111111111111111111111111111111111111111111111111111111111111111111111111111111
1111111111111111111111111111111111111111111111111111111111111111111111111111111111111111111111111111
1111111111111111111111111111111111111111111111111111111111111111111111111111111111111111111111111111
1111111111111111111111111111111111111111111111111111111111111111111111111111111111111111111111111111
1111111111111111111111111111111111111111111111111111111111111111111111111111111111111111111111111111
1111111111111111111111111111111111111111111111111111111111111111111111111111111111111111111111111111
1111111111111111111111111111111111111111111111111111111111111111111111111111111111111111111111111111
1111111111111111111111111111111111111111111111111111111111111111111111111111111111111111111111111111
1111111111111111111111111111111111111111111111111111111111111111111111111111111111111111111111111111
1111111111111111111111111111111111111111111111111111111111111111111111111111111111111111111111111111
1111111111111111111111111111111111111111111111111111111111111111111111111111111111111111111111111111
1111111111111111111111111111111111111111111111111111111111111111111111111111111111111111111111111111
1111111111111111111111111111111111111111111111111111111111111111111111111111111111111111111111111111
1111111111111111111111111111111111111111111111111111111111111111111111111111111111111111111111111111
1111111111111111111111111111111111111111111111111111111111111111111111111111111111111111111111111111
1111111111111111111111111111111111111111111111111111111111111111111111111111111111111111111111111111
1111111111111111111111111111111111111111111111111111111111111111111111111111111111111111111111111111
1111111111111111111111111111111111111111111111111111111111111111111111111111111111111111111111111111
1111111111111111111111111111111111111111111111111111111111111111111111111111111111111111111111111111
1111111111111111111111111111111111111111111111111111111111111111111111111111111111111111111111111111
1111111111111111111111111111111111111111111111111111111111111111111111111111111111111111111111111111
1111111111111111111111111111111111111111111111111111111111111111111111111111111111111111111111111111
1111111111111111111111111111111111111111111111111111111111111111111111111111111111111111111111111111
1111111111111111111111111111111111111111111111111111111111111111111111111111111111111111111111111111
1111111111111111111111111111111111111111111111111111111111111111111111111111111111111111111111111111
1111111111111111111111111111111111111111111111111111111111111111111111111111111111111111111111111111
1111111111111111111111111111111111111111111111111111111111111111111111111111111111111111111111111111
1111111111111111111111111111111111111111111111111111111111111111111111111111111111111111111111111111
1111111111111111111111111111111111111111111111111111111111111111111111111111111111111111111111111111
1111111111111111111111111111111111111111111111111111111111111111111111111111111111111111111111111111
1111111111111111111111111111111111111111111111111111111111111111111111111111111111111111111111111111
1111111111111111111111111111111111111111111111111111111111111111111111111111111111111111111111111111
1111111111111111111111111111111111111111111111111111111111111111111111111111111111111111111111111111
1111111111111111111111111111111111111111111111111111111111111111111111111111111111111111111111111111
1111111111111111111111111111111111111111111111111111111111111111111111111111111111111111111111111111
1111111111111111111111111111111111111111111111111111111111111111111111111111111111111111111111111111
1111111111111111111111111111111111111111111111111111111111111111111111111111111111111111111111111111
1111111111111111111111111111111111111111111111111111111111111111111111111111111111111111111111111111